gruezi	gruezi_(greet)
gruezi	gruezi_(greet)
gueten abig	gueten_abig_(greet)
ade	ade_(bye)
schone namittag	schone_namittag_(bye)
schone nami	schone_nami_(bye)
bonne soiree	bonne_soiree_(bye)
a toute a l'heure	a_toute_a_l'heure_(bye)
aurevoir	aurevoir_(bye)
godkvall	godkvall_(greet)
hejda	hejda_(bye)
schoenen guten abend	schoenen_guten_abend_(bye)
guten morgen	guten_morgen_(greet)
guten morgen	guten_morgen_(greet)
guten tag	guten_tag_(greet)
guten abend	guten_abend_(greet)
danke schoen	danke_schoen_(thank)
schoenen tag	schoenen_tag_(bye)
tschuess	tschuess_(bye)
servus	servus_(hi/bye)
danke	danke_(thank)
bis spater	bis_spater_(bye)
beste	beste
schone	schone
hullo	hullo_(greet)
goeden dag	goeden_dag_(greet)
dobry den	dobry_den_(greet)
dobre rano	dobre_rano_(greet)
dobre dopoledne	dobre_dopoledne_(greet)
dobre odpoledne	dobre_odpoledne_(greet)
dobry vecer	dobry_vecer_(greet)
dobry podvecer	dobry_podvecer_(greet)
pekny den	pekny_den_(bye)
hezky vecer	hezky_vecer_(bye)
naslysenou	naslysenou_(bye)
naslys	naslys_(bye)
ahoj	ahoj_(hi/bye)
podvecer	podvecer
vecer	vecer
ahojte	ahojte
dobre popoludnie	dobre_popoludnie_(greet)
pekne popoludnie	pekne_popoludnie_(bye)
pekne popoludnie	pekne_popoludnie_(bye)
pekny let	pekny_let_(bye)
pekny let	pekny_let_(bye)
dopocutia	dopocutia_(bye)
